size: 20x30
players: 3

..............................
..............................
............33333.............
G............................G
G............................G
G............................G
G............................G
G.1........................2.G
G.1........................2.G
G.1...........B............2.G
G.1........................2.G
G.1..................W.....2.G
G....................W.......G
G....................W.......G
G......WWW...................G
G............................G
G............................G
..............................
..............................
..............................