size: 20x28
players: 2

G..........................G
G..........................G
G..........................G
G..........................G
G..........................G
G..........................G
G..........................G
G..........................G
G.1......................2.G
G.1...........B..........2.G
G.1......................2.G
G.1......................2.G
G..........................G
G..........................G
G..........................G
G..........................G
G..........................G
G..........................G
G..........................G
G..........................G