size: 20x30
players: 2

G............................G
G............................G
G............................G
G............................G
G............................G
G............................G
G............................G
G.P........................P.G
G.P........................P.G
G.P...........B............P.G
G.P........................P.G
G.P........................P.G
G............................G
G............................G
G............................G
G............................G
G............................G
G............................G
G............................G
G............................G